agility			민첩성
have yet to ~ 		아직 ~ 하지 않았다.
adhesive		접착제
hold fast to		~을 꽉 붙잡다. 			(도마뱀은 벽을 hold fast to 한다.
humidity 		습기
bristle			강모, 강한 털
surface tension 	표면 장력
adhesion		접착력
facilely		손쉽게
skitter			빠르게 달리다. 			(도마뱀은 천장에서 빠르게 달릴 수 있다.)
gecko			도마뱀 붙이
paramount		가장 중요한			(물은 인간에게 가장 중요하다.)
advisory		정보, 보고				(고속도로 상황 보고, 정보통)
bypass			우회하다.
tractor trailer		대형 화물 트럭
overturn		전복시키다.			(차를 뒤집어 버리다.)
endurance		인내


autograph		사인
know ~ by hear		~을 외우다. 			(암기, 기억하다.)
throw in		~을 덤으로 주다.
mingle with		~와 어울리다. 			(친구와 어울리다.)
dairy farmer		낙농업자. [데뤼 파멀]
spread 			스프레드 				(빵에 바르는 버터 따위)

convine 		소집하다.
beneficiary		수혜자
pressing		시급한
food colorant		식용 색소 	
delegate 		대표
commitment		헌신, 공헌
convention		대회, 협의회

span			(지역에) 걸치다.
all but			거의
grapple with		~와 씨름하다.
grit			투지
ordeal			시련
reiterate		다시 말하다. 반복하다.
replicate		재현하다.
